[~NAMES-INCLUDED~]//Don't edit or remove this line.
Suspect=Suspect
Suspects=Suspects
Hostile=Hostile
Hostiles=Hostiles
Civilian=Civilian
Civilians=Civilians
Hostage=Hostage
Hostages=Hostages
Age=Age
Audio=Audio
Timeline=Timeline
Transcript=Transcript
Objective=Objective
Objectives=Objectives
Challenge=Challenge
Challenges=Challenges
Height=Height
Heights=Heights
Weight=Weight
Weights=Weights
Code=Code
Codes=Codes
Name=Name
Names=Names
Media=Media
Intel=Intel
team.Swat=S.W.A.T.
team.MLO=MLO
menu.Esc.Resume=Resume Game
menu.Esc.Invite=Invite Friends
menu.Options=Options
menu.Esc.Vote=Call a Vote
menu.Bug=Report Bug
menu.Ticket=Submit Ticket
menu.Esc.Admin=Server Admin
menu.Esc.Quit=Quit to Main Menu
ticket.Submit.Title=Submit a Ticket
Password=Password
Password.Login=Log In
Login=Login
ticket.Submit.Subject=Ticket Type
ticket.Submit.Subject.TechSupport=Technical Support
ticket.Submit.Subject.Question=Ask a Question
EmailAddress=Email Address
Message=Message
ticket.Submit.Message.Hint=Be as detailed as possible
ticket.Submit.Email.Hint=Give us a means to reach you
Cancel=Cancel
Continue=Continue
Accept=Accept
Decline=Decline
Back=Back
Confirm=Confirm
Submit=Submit
ticket.Submit=Submit Ticket
Game=Game
Graphics=Graphics
Controls=Controls
Exit=Exit
Multiplayer=Multiplayer
Movement=Movement
Equipment=Equipment
Vehicle=Vehicle
Interaction=Interaction
Teamwork=Teamwork
Misc=Misc
bug.Report.Category=Bug Category
bug.Report.Title=Report a Bug
bug.Report.Subject=Subject Line
bug.Report.Description=Bug Description
bug.Report.Subject.Desc=Give a title for your bug.
bug.Report.Description.Desc=What were you doing when the bug occured? Please be as detailed as possible.
Unbound=Unbound
error.NoData=No Data
Stats=Stats
Play=Play
menu.btn.Quit=Exit Game
Select=Select
All=All
swat.Self=Self
swat.Alpha=Alpha
swat.Bravo=Bravo
swat.Delta=Delta
swat.Charlie=Charlie
Empty=Empty
None=None
Clear=Clear
Default=Default
phrase.TimeOfDay=time of day
Close=Close
Munitions=Munitions
menu.HideUI=Hide UI
Menu=Menu
menu.HideBriefing=Hide briefing
error.MinCharacterLimit=Min character limit: {n}
error.MaxCharacterLimit=Max character limit: {n}
